Emoji	English
ğŸ‡	grapes
ğŸ‰	watermelon
ğŸŠ	orange
ğŸ‹	lemon
ğŸŒ	banana
ğŸ	pineapple
ğŸ¥­	mango
ğŸ	apple
ğŸ	pear
ğŸ‘	peach
ğŸ’	cherry
ğŸ“	strawberry
ğŸ«	blueberry
ğŸ¥	kiwifruit
ğŸ…	tomato
ğŸ¥¥	coconut
ğŸ¥‘	avocado
ğŸ†	eggplant
ğŸ¥”	potato
ğŸ¥•	carrot
ğŸŒ½	corn
ğŸŒ¶ï¸	chili pepper
ğŸ«‘	bell pepper
ğŸ¥’	cucumber
ğŸ¥¬	lettuce
ğŸ¥¦	broccoli
ğŸ§„	garlic
ğŸ§…	onion
